франкфурт-на-майне	франкфурт -на -майн е
франкфурт	франкфурт
основополагающий	основополаг а ющ ий
полный	пол н ый
плексигласовый	плексиглас ов ый
химический	хим ическ ий
неподтвержденный	не подтвержд енн ый
качественный	кач еств енн ый
древневерхненемецкий	древн е верхн е немец к ий
немецкий	не мец к ий
обувнозаготовочный	обувн о за гот ов оч н ый
древний	древн ий
сентиментальность	сенти менталь н ость
чувствительность	чувств и тельн ость
заблагорассудиться	за благорас суд и ть ся
краситься	крас и ть ся
самогоноварение	сам о гон овар ени е
наркопреступность	наркопреступ н ость
полуразложившийся	по лураз ложив ш ий ся
полураспавшийся	по лурас пав ш ий ся
шумозаградительный	шум о за град и тельн ый
обеспечительный	о бес печ и тельн ый
нерасследованный	нерасслед ова нн ый
следственный	след ств енн ый
неосуществленный	не о существл енн ый
нереализованный	не реал из ова нн ый
люминесцентный	люминес центн ый
жирный	жир н ый
кровезаменитель	кро веза мен и тель
каратель	кар а тель
песчано-гравийный	песчан о -грав ий н ый
асфальтобетонный	асфальт о бетон н ый
валяносапожник	вал я носапож ник
башмачник	башмач ник
необуржуазный	не обуржуаз н ый
опасный	опас н ый
междоусобица	межд о у собиц а
война	войн а
непотопляемый	не по то пл я ем ый
верный	верн ый
лейб-гвардейский	лейб -г вардей ск ий
житейский	житей ск ий
предынфарктный	предынфаркт н ый
коматозный	комат оз н ый
завербовывать	за вербов ыва ть
нанимать	на ним а ть
склеропластика	склеро пласти к а
информатика	информати к а
неукоснительно	не укосн и тельн о
ветрено	ветр ен о
неоплатонизм	нео плат он изм
комизм	ком изм
поисково-спасательный	по иск о во -спас а тельн ый
пастельный	пас тельн ый
коксующийся	кокс у ющ ий ся
угольный	уголь н ый
эластокинематический	эластокинемат ическ ий
кинематический	кинемат ическ ий
восемьсотпятидесятилетие	восемьсотпят и десят и лет и е
возмездие	воз мез дие
неопознанный	нео позна нн ый
неизвестный	не из вестн ый
горюче-смазочный	горюче-смаз оч н ый
топливный	топливн ый
попустительствовать	по пуст и тель ств ова ть
потакать	потак а ть
спецслужбист	спецслужб ист
коммунист	коммун ист
самозатачивающийся	сам о затач ива ющ ий ся
твердосплавный	твердосплавн ый
биокибернетик	био кибернетик
учёный	уч ён ый
невосприимчивый	не воспри имчив ый
неподверженный	не под верж енн ый
ханты-мансийск	ханты -манс ий ск
торонто	торонт о
центрально-черноземный	цен тр аль н о -чернозем н ый
сонный	со нн ый
сергиево-посадский	сергиев о -посад ск ий
московский	моск ов ск ий
раннеперестроечный	раннепере стр о еч н ый
позднесоветский	позднес овет ск ий
нормальненько	нормальненьк о
сухо	сух о
залогодержатель	за логодерж а тель
банк	банк
азиатско-тихоокеанский	аз иат ск о -тих о океан ск ий
дальневосточный	дальневосточ н ый
гастроэнтеролог	гастр о энтер о лог
врач	врач
конституционно-правовой	конституционн о -прав ов ой
юридический	юрид ическ ий
камнесамоцветный	камнесам о цвет н ый
драгоценный	драгоц енн ый
горношахтный	горношахт н ый
промышленный	промышл енн ый
нечленораздельный	не членораз дель н ый
безмерный	без мер н ый
белогвардеец	белог варде ец
империя	импер и я
электронно-механический	электр о нн о -механ ич еск ий
эпический	эп ическ ий
пуленепробиваемый	пуленепро бива ем ый
бронированный	брон ир ова нн ый
пенополиуританин	пенополиуританин
кефир	кефир
бессквозняковый	бес ск возняк ов ый
безветреный	без ветр ен ый
вестминстерский	вестминстер ск ий
лондонский	лондон ск ий
сногсшибательный	сногсшиб а тельн ый
завистливый	за вист лив ый
полиизобутилен	полииз обутилен
поливинилацетат	по ливинилацетат
грузино-абхазский	груз ин о -абхаз ск ий
кавказский	кавказ ск ий
детоталитаризация	детоталитар из аци я
стол	стол
слабоминерализованный	слабо минерал из ова нн ый
гидрокарбонатный	гидр о карбонат н ый
авиационно-космический	ави аци онн о -к о см ическ ий
воздушный	воздуш н ый
сталелитейный	сталелитей н ый
заводской	за вод ск ой
спринтерский	спринтер ск ий
атлетический	атлет ическ ий
звукозаписывающий	звук о за пис ыва ющ ий
студийный	студ ий н ый
конкуретноспособность	конкуретноспособ н ость
предпринимательство	предпри ним а тель ств о
неремонтопригодный	не ремонт о при год н ый
былой	был ой
уголовно-процессуальный	уголовн о -про цессуаль н ый
судебный	судеб н ый
приснопамятный	при снопа мят н ый
темпераментный	темпераментн ый
чехословацкий	чехосл ова цк ий
чешский	чеш ск ий
полузамерзший	по лу за мерз ш ий
сиреневый	сир ен ев ый
взаимозаменяемый	взаим о за мен яем ый
альтернативный	альтернативн ый
неостановимый	не о станов им ый
воображаемый	воображ а ем ый
налогооблагаемый	на лог о облагаем ый
материальный	материаль н ый
рационализаторский	рационализ атор ск ий
классный	класс н ый
длиннобазный	длиннобаз н ый
вытянутый	вы тяну т ый
поскальзываться	по скальз ыва ть ся
спотыкаться	спотык а ть ся
легкоусвояемый	легк о у свояем ый
диетический	диет ическ ий
хлопчатобумажный	хлопч ат о бумаж н ый
ткацкий	ткацк ий
закоренелый	за корен е л ый
усталый	у стал ый
желудочно-кишечный	желудоч н о -кишеч н ый
врачебный	врачеб н ый
квадратно-гнездовой	квадрат н о -гнезд ов ой
квадратный	квадрат н ый
гражданско-процессуальный	гражданск о -про цессуаль н ый
общеправовой	об щеправ ов ой
неосторожный	не о сторож н ый
неаккуратный	не акк урат н ый
приспосабливаться	при спосабл ива ть ся
умудряться	умудр я ть ся
рабоче-крестьянский	рабоче-кресть ян ск ий
пролетарский	про летар ск ий
тетраэтилсвинец	тетраэтилсвин ец
свинец	свин ец
морально-нравственный	мор аль н о -нрав ств енн ый
этический	эт ическ ий
незатасканный	не затаск а нн ый
неистрепанный	не истрепа нн ый
неизбирабельный	не из бирабель н ый
стойкий	стойк ий
социально-политический	соци аль н о -полит ическ ий
экономический	эк о ном ическ ий
двухъярусный	дв ухъярус н ый
плотный	плотн ый
беллинсгаузен	беллинсгауз ен
крузенштерн	круз енштерн
древесностружечный	древесностружеч н ый
строительный	стр о и тельн ый
непропорциональность	не пропорциона ль н ость
диспропорциональность	диспропорциона ль н ость
горно-обогатительный	горн о -обогат и тельн ый
восхитительный	восхит и тельн ый
исправительно-трудовой	исправ и тельн о -труд ов ой
лагерный	лагер н ый
сердечно-сосудистый	сердеч н о -сосуд ист ый
кровеносный	кровенос н ый
всепобеждающий	всеп о бежд а ющ ий
кожаный	кож ан ый
небезызвестный	не без ыз вестн ый
знаменитый	зна мени т ый
приноравливаться	при норавл ива ть ся
приспособляться	при способл я ть ся
набалдашник	на балдаш ник
чиновник	чинов ник
всеохватывающий	всео хват ыва ющ ий
всеобъемлющий	всеобъемл ющ ий
совершеннолетний	со верш еннолет н ий
тетрадный	тетрадн ый
претенциозный	прет енци оз н ый
пафосный	пафосн ый
